WWWWWWWWWWWWWWW
W    WW     WWW
WS W WW WWW   W
WW   W     WW W
WW WW  WWW WWWW
WW  W WW     WW
WWW W WW WWWWWW
W   W  W W    W
W WWW WW W W WW
W   W WW W W WW
W W W  W W WWWW
W W  W W W W EW
W WW   W   W WW
W W  W  WW   WW
WWWWWWWWWWWWWWW